25 25
100 100
4 10 10 10 10 10 10 10 10 10 10 10 10 10 10 10 10 10 10 10 10 10 10 10 5
8 1  1  1  10 1  1  1  1  1  1  1  1  1  1  1  1  1  1  1  1  1  1  1  9
8 1  1  1  10 1  10 10 10 10 10 10 10 10 10 10 10 10 10 10 10 10 10 1  9
8 1  1  1  10 1  10 1  1  1  1  1  1  1  1  1  1  1  1  1  1  1  10 1  9
8 1  1  1  10 1  10 1  1  1  1  1  1  1  1  1  1  1  1  1  1  1  10 1  9
8 1  1  1  10 1  10 1  1  10 10 10 10 10 10 10 10 10 10 10 10 1  10 1  9
8 1  1  1  10 1  10 1  1  10  1  1  1  1  1  1  1  1  1  1 10 1  10 1  9
8 1  1  1  10 1  10 1  1  10  1  1  1  1  1  1  1  1  1  1 10 1  10 1  9
8 1  1  1  10 1  10 1  1  10  1  1  1  1  1  1  1  1  1  1 10 1  10 1  9
8 1  1  1  10 1  10 1  1  10  1  1  1  1  1  1  1  1  1  1 10 1  10 1  9
8 1  1  1  10 1  10 1  1  10  1  1  1  1  1  1  1  1  1  1 10 1  10 1  9
8 1  1  1  10 1  10 1  1  10  1  1  1  1  1  1  1  1  1  1 10 1  10 1  9
8 1  1  1  10 1  10 1  1  10  1  1  1  1  1  1  1  1  1  1 10 1  10 1  9
8 1  1  1  10 1  10 1  1  10  1  1  1  1  1  1  1  1  1  1 10 1  10 1  9
8 1  1  1  10 1  10 1  1  10  1  1  1  1  1  1  1  1  1  1 10 1  10 1  9
8 1  1  1  10 1  10 1  1  10  1  1  1  1  1  1  1  1  1  1 10 1  10 1  9
8 1  1  1  10 1  10 1  1  1  1  1  1  1  1  1  1  1  1  1  10 1  10 1  9
8 1  1  1  10 1  10 1  1  1  1  1  1  1  1  1  1  1  1  1  10 1  10 1  9
8 1  1  1  10 1  10 10 10 10 10 10 10 10 10 10 10 10 10 10 10 1  10 1  9
8 1  1  1  10 1  1  1  1  1  1  1  1  1  1  1  1  1  1  1  1  1  10 1  9
8 1  1  1  10 10 10 10 10 10 10 10 10 10 10 10 10 10 10 10 10 10 10 1  9
8 1  1  1  1  1  1  1  1  1  1  1  1  1  1  1  1  1  1  1  1  1  1  1  9
8 1  1  1  1  1  1  1  1  1  1  1  1  1  1  1  1  1  1  1  1  1  1  1  9
8 1  1  1  1  1  1  1  1  1  1  1  1  1  1  1  1  1  1  1  1  1  1  1  9
7 11 11 11 11 11 11 11 11 11 11 11 11 11 11 11 11 11 11 11 11 11 11 11 6